name	taxonomy_id	taxonomy_lvl	kraken_assigned_reads	added_reads	new_est_reads	fraction_total_reads
Streptococcus sp. oral taxon 431	712633	S	1909	19	1928	0.00439
Halothece sp. PCC 7418	65093	S	12	3	15	0.00004
Actinoplanes missouriensis	1866	S	430	47	477	0.00109
Sugiyamaella lignohabitans	796027	S	346	261	607	0.00139
Streptomyces rubrolavendulae	285473	S	165	18	183	0.00042
Xanthomonas citri	346	S	11	131	142	0.00032
Xanthomonas oryzae	347	S	67	8	75	0.00017
Xanthomonas translucens	343	S	224	11	235	0.00054
Geobacter sp. M18	443143	S	40	8	48	0.00011
Geobacter sp. M21	443144	S	25	8	33	0.00008
Rhizobium sp. N324	1703969	S	77	0	77	0.00018
Saccharomyces cerevisiae	4932	S	331	174	505	0.00115
Streptomyces sp. CFMR 7	1649184	S	129	32	161	0.00037
Actinomyces sp. oral taxon 414	712122	S	640	33	673	0.00153
Planctomyces sp. SH-PL62	1636152	S	186	5	191	0.00044
Serratia plymuthica	82996	S	24	7	31	0.00007
Caulobacter henricii	69395	S	132	13	145	0.00033
Pseudomonas fragi	296	S	67	3	70	0.00016
Pseudomonas fluorescens	294	S	1243	361	1604	0.00366
Burkholderia cepacia	292	S	85	239	324	0.00074
Pandoravirus dulcis	1349409	S	31	2	33	0.00008
Cyanothece sp. ATCC 51142	43989	S	11	1	12	0.00003
Corynebacterium epidermidicanis	1050174	S	100	4	104	0.00024
Thermus thermophilus	274	S	35	16	51	0.00012
Meiothermus ruber	277	S	25	0	25	0.00006
Prevotella sp. oral taxon 299	652716	S	270	12	282	0.00064
Pseudonocardia sp. EC080625-04	1096868	S	13	467	480	0.00110
Aequorivita sublithincola	101385	S	12	0	12	0.00003
Cronobacter dublinensis	413497	S	13	13	26	0.00006
Micavibrio aeruginosavorus	349221	S	22	0	22	0.00005
Pseudomonas sp. CCOS 191	1649877	S	30	8	38	0.00009
Frondihabitans sp. PAMC 28766	1795630	S	532	18	550	0.00125
Variovorax sp. PAMC 28711	1795631	S	550	41	591	0.00135
Runella slithyformis	106	S	27	0	27	0.00006
Pseudomonas mandelii	75612	S	69	5	74	0.00017
Rothia dentocariosa	2047	S	2314	96	2410	0.00549
Pimelobacter simplex	2045	S	1534	101	1635	0.00373
Aeromicrobium erythreum	2041	S	622	33	655	0.00149
Staphylococcus phage StB20-like	1732064	S	12	0	12	0.00003
Shinella sp. HZN7	879274	S	363	0	363	0.00083
Intrasporangium calvum	53358	S	658	33	691	0.00157
Synechococcus sp. JA-3-3Ab	321327	S	114	116	230	0.00052
Acidobacterium capsulatum	33075	S	28	0	28	0.00006
Akkermansia glycaniphila	1679444	S	16	0	16	0.00004
Alicycliphilus denitrificans	179636	S	210	93	303	0.00069
Brevundimonas naejangsanensis	588932	S	472	19	491	0.00112
Streptomyces violaceusniger	68280	S	194	12	206	0.00047
Amycolatopsis japonica	208439	S	88	64	152	0.00035
Lactobacillus ruminis	1623	S	15	0	15	0.00003
[Mannheimia] succiniciproducens	157673	S	11	0	11	0.00003
Lactobacillus salivarius	1624	S	173	3	176	0.00040
Kocuria flava	446860	S	526	29	555	0.00127
Streptomyces sp. CCM_MD2014	1561022	S	65	24	89	0.00020
Curtobacterium sp. MR_MD2014	1561023	S	599	79	678	0.00155
Burkholderia sp. Bp7605	1740163	S	32	1	33	0.00008
Streptomyces puniciscabiei	164348	S	137	24	161	0.00037
Pectobacterium carotovorum	554	S	18	1	19	0.00004
Enterobacter cloacae	550	S	35	46	81	0.00019
Pantoea ananatis	553	S	54	1	55	0.00013
Frankia inefficax	298654	S	382	12	394	0.00090
Frankia sp. EAN1pec	298653	S	261	14	275	0.00063
Corynebacterium falsenii	108486	S	140	24	164	0.00038
Pseudopropionibacterium propionicum	1750	S	619	28	647	0.00148
Arthrobacter sp. ATCC 21022	1771959	S	16	40	56	0.00013
Kocuria rhizophila	72000	S	674	37	711	0.00162
Actinomyces radicidentis	111015	S	293	30	323	0.00074
Mycobacterium vaccae	1810	S	282	9	291	0.00067
Brevundimonas sp. GW460-12-10-14-LB2	1827469	S	598	79	677	0.00154
Actinosynnema mirum	40567	S	302	48	350	0.00080
Staphylococcus hyicus	1284	S	87	1	88	0.00020
Pandoraea oxalativorans	573737	S	17	6	23	0.00005
Staphylococcus simulans	1286	S	190	1	191	0.00044
Staphylococcus carnosus	1281	S	106	3	109	0.00025
Staphylococcus aureus	1280	S	1474	1574	3048	0.00695
Staphylococcus haemolyticus	1283	S	5624	233	5857	0.01335
Staphylococcus epidermidis	1282	S	7041	506	7547	0.01720
Staphylococcus xylosus	1288	S	339	2	341	0.00078
Lactobacillus acidophilus	1579	S	108	60	168	0.00038
Dyella thiooxydans	445710	S	122	12	134	0.00031
Geminocystis sp. NIES-3709	1617448	S	13	54	67	0.00015
Halobacillus halophilus	1570	S	10	0	10	0.00002
Leifsonia xyli	1575	S	746	50	796	0.00181
Mycobacterium sp. JS623	212767	S	303	5	308	0.00070
Paludibacter propionicigenes	185300	S	14	0	14	0.00003
Chromobacterium vaccinii	1108595	S	60	12	72	0.00017
Desulfovibrio africanus	873	S	20	0	20	0.00005
Pseudomonas savastanoi	29438	S	31	4	35	0.00008
Arthrobacter sp. YC-RL1	1652545	S	34	67	101	0.00023
Nostoc sp. PCC 7107	317936	S	59	5	64	0.00015
Capnocytophaga canimorsus	28188	S	15	0	15	0.00003
Methylobacillus flagellatus	405	S	14	1	15	0.00003
Planococcus kocurii	1374	S	14	2	16	0.00004
Aerococcus viridans	1377	S	158	15	173	0.00039
Aerococcus urinae	1376	S	41	0	41	0.00009
Methylobacterium extorquens	408	S	881	141	1022	0.00233
Pseudopedobacter saltans	151895	S	36	1	37	0.00008
Adlercreutzia equolifaciens	446660	S	70	11	81	0.00019
Kluyveromyces lactis	28985	S	87	47	134	0.00031
Pseudomonas alcaligenes	43263	S	167	3	170	0.00039
Macrococcus caseolyticus	69966	S	42	0	42	0.00010
Pandoraea pulmonicola	93221	S	39	4	43	0.00010
Pandoraea pnomenusa	93220	S	49	14	63	0.00014
Pandoraea sputorum	93222	S	18	6	24	0.00006
Delftia tsuruhatensis	180282	S	208	145	353	0.00081
Martelella endophytica	1486262	S	91	1	92	0.00021
Methylophilus sp. TWE2	1662285	S	14	0	14	0.00003
Agrobacterium vitis	373	S	75	0	75	0.00017
Thioalkalivibrio sulfidiphilus	1033854	S	35	0	35	0.00008
Bradyrhizobium japonicum	375	S	250	132	382	0.00087
Bradyrhizobium sp.	376	S	185	19	204	0.00047
Pseudomonas balearica	74829	S	59	7	66	0.00015
Ruegeria sp. TM1040	292414	S	23	2	25	0.00006
Actinoplanes sp. N902-109	649831	S	476	40	516	0.00118
Rhizobium phaseoli	396	S	90	0	90	0.00021
Neorhizobium galegae	399	S	296	0	296	0.00067
Candidatus Accumulibacter phosphatis	327160	S	66	0	66	0.00015
Butyrivibrio hungatei	185008	S	13	2	15	0.00004
Caulobacteraceae bacterium OTSz_A_272	1759059	S	41	0	41	0.00009
Alicyclobacillus acidocaldarius	405212	S	38	0	38	0.00009
Citrobacter sp. FDAARGOS_156	1702170	S	10	0	10	0.00002
Parabacteroides sp. YL27	1834200	S	17	0	17	0.00004
Erysipelotrichaceae bacterium I46	1834207	S	85	0	85	0.00019
Achromobacter denitrificans	32002	S	61	26	87	0.00020
Kozakia baliensis	153496	S	34	3	37	0.00008
Altererythrobacter ishigakiensis	476157	S	37	0	37	0.00009
Mobiluncus curtisii	2051	S	358	4	362	0.00083
Gordonia terrae	2055	S	299	30	329	0.00075
Gordonia bronchialis	2054	S	152	9	161	0.00037
Sphaerobacter thermophilus	2057	S	75	0	75	0.00017
Eggerthella lenta	84112	S	74	2	76	0.00018
Oscillatoria acuminata	118323	S	29	1	30	0.00007
Slackia heliotrinireducens	84110	S	25	0	25	0.00006
Corynebacterium uterequi	1072256	S	174	4	178	0.00041
Enterococcus mundtii	53346	S	19	0	19	0.00004
Sphingobium sp. RAC03	1843368	S	262	11	273	0.00062
Piscine myocarditis-like virus	1798085	S	25	0	25	0.00006
Rubrobacter xylanophilus	49319	S	101	2	103	0.00024
Cupriavidus pinatubonensis	248026	S	91	17	108	0.00025
Pseudomonas alkylphenolia	237609	S	77	2	79	0.00018
Pseudoxanthomonas spadix	415229	S	151	12	163	0.00037
Sodalis praecaptivus	1239307	S	10	13	23	0.00005
Bacteroides cellulosilyticus	246787	S	403	7	410	0.00094
Gemmatimonas aurantiaca	173480	S	44	0	44	0.00010
Pantoea rwandensis	1076550	S	13	0	13	0.00003
Altererythrobacter atlanticus	1267766	S	98	16	114	0.00026
Opitutus terrae	107709	S	73	3	76	0.00017
Microbacterium sp. No. 7	1714373	S	808	86	894	0.00204
Staphylococcus phage phiIPLA-C1C	1572704	S	44	14	58	0.00013
Mycobacterium immunogenum	83262	S	65	8	73	0.00017
Aminobacter aminovorans	83263	S	227	12	239	0.00054
Acinetobacter nosocomialis	106654	S	52	2	54	0.00012
Sphingobium sp. EP60837	1855519	S	137	9	146	0.00033
Bradyrhizobium oligotrophicum	44255	S	248	21	269	0.00061
Erwinia gerundensis	1619313	S	55	2	57	0.00013
Paenibacillus durus	44251	S	15	1	16	0.00004
Paenibacillus beijingensis	1126833	S	17	0	17	0.00004
Deinococcus geothermalis	68909	S	35	0	35	0.00008
Cupriavidus metallidurans	119219	S	76	21	97	0.00022
Haliangium ochraceum	80816	S	141	2	143	0.00033
Salinispora arenicola	168697	S	123	18	141	0.00032
Salinispora tropica	168695	S	104	18	122	0.00028
Leadbetterella byssophila	316068	S	15	0	15	0.00003
Sulfuritalea hydrogenivorans	748811	S	63	0	63	0.00015
Corynebacterium testudinoris	136857	S	154	7	161	0.00037
Paenibacillus sp. 32O-W	1695218	S	16	0	16	0.00004
Mycobacterium sp. JLS	164757	S	35	137	172	0.00039
Mycobacterium kansasii	1768	S	201	42	243	0.00056
Myxococcus stipitatus	83455	S	49	8	57	0.00013
Gluconacetobacter diazotrophicus	33996	S	145	4	149	0.00034
Nitrosococcus halophilus	133539	S	20	3	23	0.00005
Mycobacterium fortuitum	1766	S	40	147	187	0.00043
Mycobacterium intracellulare	1767	S	33	284	317	0.00072
Mycobacterium avium	1764	S	269	35	304	0.00069
Synechococcus sp. CC9902	316279	S	12	3	15	0.00004
Collimonas arenae	279058	S	70	6	76	0.00017
Granulicella mallensis	940614	S	57	1	58	0.00013
Granulicella tundricola	940615	S	73	2	75	0.00017
Salinibacter ruber	146919	S	31	0	31	0.00007
Zymomonas mobilis	542	S	31	0	31	0.00007
Citrobacter freundii	546	S	737	50	787	0.00179
[Enterobacter] aerogenes	548	S	25	23	48	0.00011
Pantoea agglomerans	549	S	1300	34	1334	0.00304
Lachnoclostridium sp. YL32	1834196	S	133	2	135	0.00031
Deinococcus puniceus	1182568	S	83	1	84	0.00019
Ruminiclostridium sp. KB18	1834198	S	66	0	66	0.00015
Selenomonas sp. oral taxon 136	713030	S	14	5	19	0.00005
Methylococcus capsulatus	414	S	40	0	40	0.00009
Colwellia psychrerythraea	28229	S	15	1	16	0.00004
Desulfuromonas sp. DDH964	1823759	S	36	2	38	0.00009
Exiguobacterium sibiricum	332410	S	10	6	16	0.00004
Pseudomonas sp. URMO17WK12:I11	1283291	S	109	6	115	0.00026
Atopobium parvulum	1382	S	54	5	59	0.00014
Lentzea guizhouensis	1586287	S	377	37	414	0.00094
Desulfarculus baarsii	453230	S	31	7	38	0.00009
Bacillus oceanisediminis	665099	S	10	0	10	0.00002
Corynebacterium terpenotabidum	89154	S	99	6	105	0.00024
Leptotrichia sp. oral taxon 847	1785996	S	45	0	45	0.00010
Gemella sp. oral taxon 928	1785995	S	237	1	238	0.00054
Akkermansia muciniphila	239935	S	96	3	99	0.00023
Arthrobacter sp. A3	595593	S	50	2	52	0.00012
Chryseobacterium sp. IHB B 10212	1685010	S	253	15	268	0.00061
Sinorhizobium fredii	380	S	175	2	177	0.00040
Mesorhizobium loti	381	S	310	20	330	0.00075
Sinorhizobium meliloti	382	S	180	12	192	0.00044
Leuconostoc carnosum	1252	S	231	4	235	0.00054
Rhizobium leguminosarum	384	S	452	0	452	0.00103
Staphylococcus phage Ipla5	1197952	S	17	9	26	0.00006
Azoarcus sp. KH32C	748247	S	78	2	80	0.00018
Psychromonas sp. CNPT3	314282	S	28	1	29	0.00007
Wolbachia endosymbiont of Drosophila simulans	77038	S	30	9	39	0.00009
Corynebacterium resistens	258224	S	262	41	303	0.00069
Bosea vaviloviae	1526658	S	389	27	416	0.00095
Acaryochloris marina	155978	S	17	0	17	0.00004
Streptococcus suis	1307	S	141	242	383	0.00087
Xanthomonas sacchari	56458	S	147	12	159	0.00036
Thermaerobacter marianensis	73919	S	40	0	40	0.00009
Thioalkalivibrio nitratireducens	186931	S	27	7	34	0.00008
Candidatus Filomicrobium marinum	1608628	S	13	0	13	0.00003
Mannheimia haemolytica	75985	S	22	2	24	0.00006
Pseudonocardia dioxanivorans	240495	S	616	61	677	0.00154
Methanosarcina barkeri	2208	S	150	4	154	0.00035
Methanosarcina mazei	2209	S	16	3	19	0.00005
Lactobacillus gallinarum	52242	S	36	18	54	0.00012
Sphingobacterium sp. ML3W	1538644	S	54	1	55	0.00013
Bordetella bronchialis	463025	S	76	2	78	0.00018
Pseudomonas sp. TKP	1415630	S	20	44	64	0.00015
Meiothermus silvanus	52022	S	18	0	18	0.00004
Rhodanobacter denitrificans	666685	S	142	12	154	0.00035
Streptomyces vietnamensis	362257	S	187	27	214	0.00049
Symbiobacterium thermophilum	2734	S	50	0	50	0.00011
Dickeya zeae	204042	S	18	0	18	0.00004
Lactococcus phage CB13	665883	S	14	10	24	0.00005
Corynebacterium argentoratense	42817	S	71	3	74	0.00017
Caulobacter vibrioides	155892	S	180	33	213	0.00049
Pseudoxanthomonas suwonensis	314722	S	478	48	526	0.00120
Roseiflexus castenholzii	120962	S	17	1	18	0.00004
Amycolatopsis methanolica	1814	S	336	41	377	0.00086
Acidithiobacillus caldus	33059	S	11	4	15	0.00003
Paraburkholderia phytofirmans	261302	S	48	10	58	0.00013
Sphingopyxis macrogoltabida	33050	S	510	96	606	0.00138
Sphingopyxis terrae	33052	S	229	51	280	0.00064
Sphingobium sp. YBL2	484429	S	189	44	233	0.00053
Mycobacterium sp. QIA-37	1561223	S	52	19	71	0.00016
Pseudomonas sp. StFLB209	1028989	S	61	0	61	0.00014
[Clostridium] cellulosi	29343	S	15	3	18	0.00004
Hyphomicrobium sp. MC1	717785	S	67	3	70	0.00016
Methanosarcina lacustris	170861	S	11	1	12	0.00003
Lactobacillus acetotolerans	1600	S	23	0	23	0.00005
Lactobacillus amylovorus	1604	S	61	60	121	0.00028
Streptomyces noursei	1971	S	50	58	108	0.00025
Streptomyces venezuelae	54571	S	205	27	232	0.00053
Burkholderia sp. PAMC 28687	1795874	S	35	30	65	0.00015
Pseudomonas sp. FGI182	1259844	S	19	7	26	0.00006
Bacteroidales bacterium CF	1400053	S	16	0	16	0.00004
Aerococcus sanguinicola	119206	S	15	0	15	0.00003
Syntrophus aciditrophicus	316277	S	11	0	11	0.00003
Pseudomonas citronellolis	53408	S	149	8	157	0.00036
Kocuria palustris	71999	S	8665	808	9473	0.02159
Mycobacterium chelonae	1774	S	47	17	64	0.00015
Bifidobacterium actinocoloniiforme	638619	S	16	0	16	0.00004
Mycobacterium phlei	1771	S	344	22	366	0.00084
Hymenobacter sp. DG5B	1411621	S	826	16	842	0.00192
Mycobacterium smegmatis	1772	S	257	15	272	0.00062
Leptolyngbya sp. O-77	1080068	S	15	0	15	0.00004
Corynebacterium deserti	1408191	S	54	6	60	0.00014
Dechloromonas aromatica	259537	S	35	0	35	0.00008
Leptotrichia buccalis	40542	S	181	2	183	0.00042
Gottschalkia acidurici	1556	S	23	0	23	0.00005
Campylobacter hominis	76517	S	549	1	550	0.00126
Streptomyces parvulus	146923	S	114	30	144	0.00033
Bifidobacterium animalis	28025	S	42	108	150	0.00034
Corynebacterium jeikeium	38289	S	463	196	659	0.00150
Nitrosospira multiformis	1231	S	74	0	74	0.00017
Riemerella anatipestifer	34085	S	29	3	32	0.00007
Sorangium cellulosum	56	S	422	13	435	0.00099
Chondromyces crocatus	52	S	113	2	115	0.00026
Polaromonas naphthalenivorans	216465	S	166	13	179	0.00041
Chromobacterium violaceum	536	S	37	8	45	0.00010
Cedecea neteri	158822	S	45	1	46	0.00010
Streptomyces sp. SAT1	1849967	S	139	22	161	0.00037
Streptomyces pactum	68249	S	126	31	157	0.00036
Tistrella mobilis	171437	S	142	3	145	0.00033
Comamonadaceae bacterium B1	1458426	S	67	8	75	0.00017
Novosphingobium aromaticivorans	48935	S	194	8	202	0.00046
Rhodoferax ferrireducens	192843	S	68	1	69	0.00016
Sphingobium baderi	1332080	S	163	53	216	0.00049
Geobacter metallireducens	28232	S	19	0	19	0.00005
Sedimenticola thiotaurini	1543721	S	10	0	10	0.00002
Denitrobacterium detoxificans	79604	S	13	5	18	0.00004
Yangia sp. CCB-MM3	1792508	S	156	5	161	0.00037
Bacillus cereus	1396	S	33	46	79	0.00018
[Eubacterium] eligens	39485	S	115	4	119	0.00027
Leptolyngbya sp. PCC 7376	111781	S	12	1	13	0.00003
Corynebacterium halotolerans	225326	S	334	14	348	0.00079
Gloeobacter violaceus	33072	S	31	3	34	0.00008
Altererythrobacter marensis	543877	S	106	2	108	0.00025
Pandoraea faecigallinarum	656179	S	32	5	37	0.00009
Pandoraea vervacti	656178	S	38	7	45	0.00010
Xanthomonas euvesicatoria	456327	S	17	16	33	0.00008
Sanguibacter keddieii	60920	S	465	25	490	0.00112
Bacillus subtilis	1423	S	10	69	79	0.00018
Lutibacter sp. LPB0138	1850246	S	10	0	10	0.00002
Vulgatibacter incomptus	1391653	S	65	3	68	0.00016
Pseudomonas sp. MRSN12121	1611770	S	19	20	39	0.00009
Sphingomonas sanxanigenens	397260	S	726	46	772	0.00176
Methylomonas sp. DH-1	1727196	S	18	0	18	0.00004
Mycobacterium sp. EPa45	1545728	S	207	4	211	0.00048
Arthrobacter sp. ZXY-2	1806905	S	28	57	85	0.00019
Barnesiella viscericola	397865	S	142	13	155	0.00035
Gordonia sp. QH-11	1136941	S	223	13	236	0.00054
Pseudomonas sp. VLB120	69328	S	47	2	49	0.00011
Pseudomonas syringae group genomosp. 3	251701	S	54	17	71	0.00016
Methanococcus voltae	2188	S	18	2	20	0.00005
Burkholderia lata	482957	S	40	21	61	0.00014
Thioalkalivibrio sp. K90mix	396595	S	25	1	26	0.00006
Roseibacterium elongatum	159346	S	107	2	109	0.00025
Deinococcus maricopensis	309887	S	56	1	57	0.00013
Cupriavidus gilardii	82541	S	120	19	139	0.00032
Actinoplanes friuliensis	196914	S	607	39	646	0.00147
Spirochaeta thermophila	154	S	11	0	11	0.00003
Acinetobacter sp. NCu2D-2	1608473	S	391	6	397	0.00091
Treponema denticola	158	S	11	6	17	0.00004
Roseobacter denitrificans	2434	S	18	1	19	0.00004
Planococcus sp. L10.15	1302659	S	10	1	11	0.00003
Psychrobacter cryohalolentis	330922	S	37	13	50	0.00012
Acidovorax sp. KKS102	358220	S	359	81	440	0.00100
Klebsiella sp. LTGPAF-6F	1905288	S	98	243	341	0.00078
Fimbriimonas ginsengisoli	1005039	S	39	0	39	0.00009
Streptococcus cristatus	45634	S	348	4	352	0.00080
Streptococcus halotolerans	1814128	S	19	0	19	0.00004
Methyloversatilis sp. RAC08	1842540	S	70	0	70	0.00016
Mycobacterium sp. YC-RL4	1682113	S	270	25	295	0.00067
Candidatus Symbiobacter mobilis	1436290	S	13	0	13	0.00003
Mycobacterium gilvum	1804	S	315	33	348	0.00079
Conexibacter woesei	191495	S	1273	7	1280	0.00292
Cellulosilyticum lentocellum	29360	S	25	0	25	0.00006
Burkholderia contaminans	488447	S	16	8	24	0.00006
Lactobacillus mucosae	97478	S	63	1	64	0.00015
Mycobacterium rhodesiae	36814	S	306	11	317	0.00072
Peptoniphilus sp. 1-1	875453	S	65	0	65	0.00015
Bosea sp. PAMC 26642	1792307	S	331	23	354	0.00081
Arthrobacter sp. PAMC 25486	1494608	S	90	3	93	0.00021
Corynebacterium doosanense	1121358	S	321	32	353	0.00080
Candidatus Solibacter usitatus	332163	S	79	0	79	0.00018
Bacteroides thetaiotaomicron	818	S	491	16	507	0.00116
Herbaspirillum hiltneri	341045	S	71	3	74	0.00017
Prevotella fusca	589436	S	144	13	157	0.00036
Chlamydia trachomatis	813	S	11	7	18	0.00004
Bacteroides fragilis	817	S	245	18	263	0.00060
Arthrobacter sp. FB24	290399	S	171	10	181	0.00041
Rathayibacter tritici	33888	S	634	34	668	0.00152
Lysobacter antibioticus	84531	S	217	26	243	0.00056
Limnohabitans sp. 63ED37-2	1678128	S	49	2	51	0.00012
Clostridium botulinum	1491	S	52	6	58	0.00013
Clostridium butyricum	1492	S	23	0	23	0.00005
Pseudomonas resinovorans	53412	S	89	2	91	0.00021
Hymenobacter swuensis	1446467	S	345	28	373	0.00085
Clostridioides difficile	1496	S	168	13	181	0.00041
Clostridium formicaceticum	1497	S	12	0	12	0.00003
Hymenobacter sp. APR13	1356852	S	615	55	670	0.00153
Brevibacterium linens	1703	S	731	86	817	0.00186
Corynebacterium stationis	1705	S	154	9	163	0.00037
Cellulomonas fimi	1708	S	496	47	543	0.00124
Natronococcus occultus	29288	S	11	2	13	0.00003
Corynebacterium humireducens	1223514	S	326	18	344	0.00078
Methylobacterium populi	223967	S	547	40	587	0.00134
Coriobacteriaceae bacterium 68-1-3	1531429	S	30	2	32	0.00007
Deinococcus gobiensis	502394	S	86	2	88	0.00020
Microcystis aeruginosa	1126	S	27	12	39	0.00009
Streptococcus himalayensis	1888195	S	28	0	28	0.00006
Azospira oryzae	146939	S	82	2	84	0.00019
Acetobacterium woodii	33952	S	11	0	11	0.00003
Lactobacillus johnsonii	33959	S	254	12	266	0.00061
Mycobacterium indicus pranii	35617	S	12	81	93	0.00021
Paenibacillus sabinae	365617	S	12	0	12	0.00003
Enterobacter hormaechei	158836	S	26	18	44	0.00010
Capnocytophaga ochracea	1018	S	146	42	188	0.00043
Bordetella avium	521	S	23	0	23	0.00005
Weeksella virosa	1014	S	13	0	13	0.00003
Burkholderia sp. CCGE1003	640512	S	48	5	53	0.00012
Ochrobactrum anthropi	529	S	172	7	179	0.00041
Burkholderia sp. CCGE1002	640511	S	66	7	73	0.00017
Lysobacter gummosus	262324	S	163	27	190	0.00043
Lactobacillus backii	375175	S	12	0	12	0.00003
Cloacibacillus porcorum	1197717	S	18	0	18	0.00004
Perigonia lusca single nucleopolyhedrovirus	1675865	S	10	0	10	0.00002
Candidatus Atelocyanobacterium thalassa	713887	S	19	3	22	0.00005
Glutamicibacter arilaitensis	256701	S	214	29	243	0.00056
Bifidobacterium kashiwanohense	630129	S	36	4	40	0.00009
Acetobacter pasteurianus	438	S	18	17	35	0.00008
[Eubacterium] rectale	39491	S	2101	71	2172	0.00495
Corynebacterium ulcerans	65058	S	50	5	55	0.00013
Acinetobacter sp. TGL-Y2	1407071	S	122	0	122	0.00028
Celeribacter indicus	1208324	S	162	23	185	0.00042
Pandoraea apista	93218	S	47	6	53	0.00012
Pandoraea norimbergensis	93219	S	38	2	40	0.00009
Hymenobacter sp. DG25A	1385663	S	114	53	167	0.00038
Hymenobacter sp. DG25B	1385664	S	175	71	246	0.00056
Rhodobacter sp. LPB0142	1850250	S	228	24	252	0.00057
Candidatus Carsonella ruddii	114186	S	10	0	10	0.00002
Cellvibrio japonicus	155077	S	21	0	21	0.00005
Methylobacterium sp. C1	1479019	S	116	471	587	0.00134
Azospirillum humicireducens	1226968	S	44	34	78	0.00018
Agrobacterium sp. H13-3	861208	S	50	27	77	0.00018
Amycolatopsis orientalis	31958	S	272	107	379	0.00087
Thalassospira xiamenensis	220697	S	17	0	17	0.00004
Pseudomonas denitrificans	43306	S	61	1	62	0.00014
Butyrivibrio proteoclasticus	43305	S	31	4	35	0.00008
Pseudarthrobacter phenanthrenivorans	361575	S	193	18	211	0.00048
Flavobacterium gilvum	1492737	S	159	8	167	0.00038
Calothrix parietina	32054	S	124	6	130	0.00030
Gloeocapsa sp. PCC 7428	1173026	S	41	3	44	0.00010
Amycolatopsis mediterranei	33910	S	392	0	392	0.00089
Burkholderia sp. YI23	1097668	S	21	23	44	0.00010
Burkholderia sp. OLGA172	1804984	S	38	5	43	0.00010
Prevotella dentalis	52227	S	66	3	69	0.00016
Erythrobacter litoralis	39960	S	251	10	261	0.00060
Sphingobium sp. SYK-6	627192	S	201	24	225	0.00051
Mycobacterium liflandii	261524	S	10	45	55	0.00013
Thauera humireducens	1134435	S	87	6	93	0.00021
Actinomyces sp. VUL4_3	1912795	S	11	0	11	0.00003
Isoptericola variabilis	139208	S	336	35	371	0.00085
Pseudogulbenkiania sp. NH8B	748280	S	70	3	73	0.00017
Dokdonella koreensis	323415	S	447	9	456	0.00104
Mesorhizobium australicum	536018	S	150	70	220	0.00050
Actinomyces meyeri	52773	S	281	5	286	0.00065
Acinetobacter sp. TTH0-4	1646498	S	352	6	358	0.00082
Carnobacterium sp. 17-4	208596	S	22	1	23	0.00005
Bradyrhizobium icense	1274631	S	825	28	853	0.00195
Rhodococcus erythropolis	1833	S	836	328	1164	0.00265
Pseudomonas sp. A3(2016)	1853130	S	68	3	71	0.00016
Saccharopolyspora erythraea	1836	S	377	27	404	0.00092
Pseudarthrobacter sulfonivorans	121292	S	189	10	199	0.00045
Mycobacterium abscessus	36809	S	123	19	142	0.00032
Streptococcus phage Cp-1	10747	S	10	0	10	0.00002
Capnocytophaga haemolytica	45243	S	42	1	43	0.00010
Anaeromyxobacter sp. K	447217	S	31	64	95	0.00022
Rhodococcus sp. WMMA185	679318	S	63	2	65	0.00015
Woeseia oceani	1548547	S	12	0	12	0.00003
Serratia sp. YD25	1759437	S	20	6	26	0.00006
Thermobacillus composti	377615	S	45	1	46	0.00011
Rhizobium sp. NT-26	1125847	S	114	0	114	0.00026
Bradyrhizobium sp. S23321	335659	S	205	26	231	0.00053
Limnochorda pilosa	1555112	S	54	0	54	0.00012
Campylobacter gracilis	824	S	55	0	55	0.00013
Campylobacter ureolyticus	827	S	481	2	483	0.00110
Bacteroides vulgatus	821	S	2045	152	2197	0.00501
Parabacteroides distasonis	823	S	111	2	113	0.00026
Spiribacter sp. UAH-SP71	1335757	S	14	0	14	0.00003
Capnocytophaga sp. oral taxon 323	1705617	S	199	57	256	0.00059
Herbaspirillum rubrisubalbicans	80842	S	59	9	68	0.00016
Pseudomonas monteilii	76759	S	57	1	58	0.00013
Cellulomonas flavigena	1711	S	375	30	405	0.00092
Corynebacterium diphtheriae	1717	S	508	117	625	0.00142
Corynebacterium pseudotuberculosis	1719	S	22	1	23	0.00005
Corynebacterium glutamicum	1718	S	98	724	822	0.00187
Blastococcus saxobsidens	138336	S	911	78	989	0.00225
Roseiflexus sp. RS-1	357808	S	20	2	22	0.00005
Acinetobacter johnsonii	40214	S	6220	258	6478	0.01476
Micromonospora sp. L5	648999	S	68	166	234	0.00053
Kyrpidia tusciae	33943	S	11	0	11	0.00003
Kosakonia oryzae	497725	S	13	0	13	0.00003
Salinicoccus halodurans	407035	S	68	0	68	0.00016
Anaeromyxobacter dehalogenans	161493	S	90	56	146	0.00033
Bordetella bronchiseptica	518	S	65	137	202	0.00046
Stenotrophomonas maltophilia	40324	S	1224	341	1565	0.00357
Thiomonas intermedia	926	S	49	3	52	0.00012
Staphylococcus saprophyticus	29385	S	3010	97	3107	0.00708
Alcaligenes faecalis	511	S	109	4	113	0.00026
Marivirga tractuosa	1006	S	12	0	12	0.00003
Staphylococcus capitis	29388	S	1072	9	1081	0.00246
Psychrobacter sp. G	571800	S	28	10	38	0.00009
Enterobacter sp. E20	1560339	S	489	41	530	0.00121
Altererythrobacter epoxidivorans	361183	S	81	5	86	0.00020
Cupriavidus sp. USMAA2-4	876364	S	15	186	201	0.00046
Carnobacterium inhibens	147709	S	42	3	45	0.00010
Leishmania major	5664	S	1237	23	1260	0.00287
Methanosarcina sp. MTP4	1434100	S	15	0	15	0.00004
Ornithobacterium rhinotracheale	28251	S	36	51	87	0.00020
Nostoc punctiforme	272131	S	1646	111	1757	0.00400
Pseudomonas sp. MS586	1785145	S	28	10	38	0.00009
Neisseria weaveri	28091	S	99	1	100	0.00023
Burkholderia gladioli	28095	S	165	13	178	0.00041
[Eubacterium] sulci	143393	S	40	0	40	0.00009
Rhodococcus fascians	1828	S	308	153	461	0.00105
Pelotomaculum thermopropionicum	110500	S	10	0	10	0.00002
Clostridium carboxidivorans	217159	S	11	1	12	0.00003
Cellulomonas gilvus	11	S	366	43	409	0.00093
Novosphingobium sp. PP1Y	702113	S	45	52	97	0.00022
Ruminococcus bicirculans	1160721	S	344	14	358	0.00082
Erwinia tasmaniensis	338565	S	11	6	17	0.00004
Devosia sp. H5989	1643450	S	171	5	176	0.00040
Rhodovulum sulfidophilum	35806	S	235	6	241	0.00055
Corynebacterium atypicum	191610	S	165	11	176	0.00040
Segniliparus rotundus	286802	S	54	0	54	0.00012
Halomonas huangheensis	1178482	S	18	0	18	0.00004
Citromicrobium sp. JL477	1634516	S	193	13	206	0.00047
Arthrobacter sp. LS16	1690248	S	26	56	82	0.00019
Flavisolibacter sp. LCS9	1492898	S	42	6	48	0.00011
Rhodococcus sp. WB1	1033922	S	24	62	86	0.00020
Comamonadaceae bacterium A1	1458425	S	74	8	82	0.00019
Pontibacter korlensis	400092	S	13	0	13	0.00003
Mycobacterium sp. djl-10	1879023	S	283	7	290	0.00066
Magnetospirillum gryphiswaldense	55518	S	74	1	75	0.00017
Nocardioides dokdonensis	450734	S	1568	141	1709	0.00390
Psychromonas ingrahamii	357794	S	49	1	50	0.00012
Desulfococcus oleovorans	181663	S	19	0	19	0.00004
Halothiobacillus sp. LS2	1860122	S	14	1	15	0.00003
Lactobacillus paracollinoides	240427	S	11	0	11	0.00003
Dialister pneumosintes	39950	S	18	0	18	0.00004
Draconibacterium orientale	1168034	S	11	0	11	0.00003
Mycoplasma gallisepticum	2096	S	12	12	24	0.00006
Streptomyces collinus	42684	S	141	26	167	0.00038
Paraburkholderia phymatum	148447	S	39	8	47	0.00011
Chryseobacterium sp. StRB126	878220	S	248	22	270	0.00062
Mycoplasma hyopneumoniae	2099	S	29	2	31	0.00007
Mycoplasma hominis	2098	S	16	0	16	0.00004
Candida dubliniensis	42374	S	1470	152	1622	0.00370
Rahnella sp. Y9602	741091	S	15	74	89	0.00020
Hydrogenophaga sp. PBC	795665	S	260	58	318	0.00073
Chelativorans sp. BNC1	266779	S	63	0	63	0.00014
Hyphomonas sp. Mor2	1906738	S	10	0	10	0.00002
Verrucomicrobia bacterium IMCC26134	1637999	S	42	2	44	0.00010
Dickeya dadantii	204038	S	10	4	14	0.00003
Azoarcus sp. BH72	62928	S	16	45	61	0.00014
Methylibium petroleiphilum	105560	S	319	34	353	0.00081
Gardnerella vaginalis	2702	S	2970	22	2992	0.00682
Methylocella silvestris	199596	S	105	3	108	0.00025
Brevundimonas subvibrioides	74313	S	461	11	472	0.00108
Maricaulis maris	74318	S	34	0	34	0.00008
Modestobacter marinus	477641	S	1110	91	1201	0.00274
Hyphomonas neptunium	81032	S	53	0	53	0.00012
Anabaena sp. 90	46234	S	24	21	45	0.00010
Brucella sp. 141012304	1885919	S	11	51	62	0.00014
Starkeya novella	921	S	299	6	305	0.00070
Pseudomonas cichorii	36746	S	61	1	62	0.00014
Clostridium saccharoperbutylacetonicum	36745	S	11	0	11	0.00003
Psychrobacter sp. PRwf-1	349106	S	41	0	41	0.00009
Haloterrigena turkmenica	62320	S	10	3	13	0.00003
Shewanella baltica	62322	S	21	8	29	0.00007
Labrenzia sp. CP4	1674922	S	52	0	52	0.00012
Geobacter pickeringii	345632	S	20	1	21	0.00005
Staphylococcus argenteus	985002	S	152	6	158	0.00036
Streptomyces reticuli	1926	S	140	35	175	0.00040
Nitrospira defluvii	330214	S	13	0	13	0.00003
Xanthomonas fragariae	48664	S	32	1	33	0.00008
Paraburkholderia phenoliruptrix	252970	S	12	43	55	0.00013
Porphyromonas gingivalis	837	S	107	34	141	0.00032
Candidatus Pantoea carbekii	1235990	S	10	0	10	0.00002
Prevotella ruminicola	839	S	31	0	31	0.00007
Thauera sp. MZ1T	85643	S	105	11	116	0.00027
Psychrobacter urativorans	45610	S	17	0	17	0.00004
Pedobacter cryoconitis	188932	S	127	13	140	0.00032
Desulfovibrio fairfieldensis	44742	S	30	1	31	0.00007
Ectothiorhodospira sp. BSL-9	1442136	S	16	0	16	0.00004
Pleurocapsa minor	54308	S	17	1	18	0.00004
Cyanobacterium aponinum	379064	S	14	1	15	0.00003
Streptomyces bingchenggensis	379067	S	226	14	240	0.00055
Nocardiopsis alba	53437	S	174	12	186	0.00042
Moritella viscosa	80854	S	14	0	14	0.00003
Exiguobacterium sp. AT1b	360911	S	10	0	10	0.00002
Asticcacaulis excentricus	78587	S	42	0	42	0.00010
Corynebacterium variabile	1727	S	178	40	218	0.00050
Corynebacterium callunae	1721	S	54	6	60	0.00014
Oligotropha carboxidovorans	40137	S	106	3	109	0.00025
Burkholderia sp. RPE64	758793	S	64	2	66	0.00015
Aliivibrio salmonicida	40269	S	11	0	11	0.00003
Corynebacterium imitans	156978	S	947	61	1008	0.00230
Carnobacterium sp. CP1	1564681	S	14	0	14	0.00003
Lactobacillus casei	1582	S	82	82	164	0.00038
Lactobacillus buchneri	1581	S	11	0	11	0.00003
Sphingobium sp. MI1205	407020	S	129	81	210	0.00048
Lactobacillus delbrueckii	1584	S	279	8	287	0.00065
Staphylococcus sp. AntiMn-1	1715860	S	96	226	322	0.00073
Staphylococcus equorum	246432	S	355	163	518	0.00118
Kingella kingae	504	S	33	0	33	0.00008
Singulisphaera acidiphila	466153	S	96	2	98	0.00022
Thermomicrobium roseum	500	S	23	0	23	0.00005
Yersinia enterocolitica	630	S	23671	189	23860	0.05437
Edwardsiella tarda	636	S	12	20	32	0.00007
Prochlorococcus marinus	1219	S	29	7	36	0.00008
Burkholderia sp. PAMC 26561	1795043	S	29	23	52	0.00012
Agrobacterium fabrum	1176649	S	260	4	264	0.00060
Vagococcus teuberi	519472	S	18	0	18	0.00004
Sphingomonas taxi	1549858	S	1880	41	1921	0.00438
Oscillibacter valericigenes	351091	S	47	0	47	0.00011
Rubrivivax gelatinosus	28068	S	413	43	456	0.00104
Geobacter bemidjiensis	225194	S	14	4	18	0.00004
Devosia sp. A16	1736675	S	354	9	363	0.00083
Algibacter alginolytica	1736674	S	16	0	16	0.00004
Pseudomonas cerasi	1583341	S	14	18	32	0.00007
Pluralibacter gergoviae	61647	S	22	0	22	0.00005
Enterobacter asburiae	61645	S	24	2	26	0.00006
Bordetella holmesii	35814	S	26	1	27	0.00006
Rhodococcus pyridinivorans	103816	S	29	32	61	0.00014
Arachidicoccus sp. BS20	1850526	S	30	1	31	0.00007
Selenomonas sputigena	69823	S	49	0	49	0.00011
Bacteroides ovatus	28116	S	515	12	527	0.00120
Tannerella forsythia	28112	S	67	6	73	0.00017
Streptococcus sp. A12	1759399	S	404	7	411	0.00094
Mycobacterium vanbaalenii	110539	S	287	27	314	0.00072
Mycobacterium sinense	875328	S	156	3	159	0.00036
Janthinobacterium agaricidamnosum	55508	S	181	8	189	0.00043
Ketogulonicigenium vulgare	92945	S	91	2	93	0.00021
Nonlabens sp. MIC269	1476901	S	10	0	10	0.00002
Hahella chejuensis	158327	S	12	0	12	0.00003
Alcanivorax pacificus	1306787	S	31	2	33	0.00008
Rhodococcus equi	43767	S	197	14	211	0.00048
Porcine type-C oncovirus	369960	S	11	0	11	0.00003
Dinoroseobacter shibae	215813	S	133	41	174	0.00040
Arthrobacter sp. ERGS1:01	1704044	S	165	8	173	0.00039
Fluviicola taffensis	191579	S	16	0	16	0.00004
Bacteroides salanitronis	376805	S	587	21	608	0.00139
Dyella jiangningensis	1379159	S	96	11	107	0.00025
Bacteroides dorei	357276	S	440	33	473	0.00108
Ilumatobacter coccineus	467094	S	490	2	492	0.00112
Sphingobium chlorophenolicum	46429	S	140	30	170	0.00039
Rhizobium sp. IRBG74	424182	S	88	1	89	0.00020
Planococcus plakortidis	1038856	S	18	3	21	0.00005
Chryseobacterium sp. IHB B 17019	1721091	S	198	15	213	0.00049
Bosea sp. RAC05	1842539	S	419	34	453	0.00103
Ramlibacter tataouinensis	94132	S	685	71	756	0.00172
Streptococcus infantarius	102684	S	23	11	34	0.00008
Porphyrobacter sp. LM 6	1896196	S	144	9	153	0.00035
Acidovorax sp. RAC01	1842533	S	176	25	201	0.00046
Sinorhizobium sp. RAC02	1842534	S	241	0	241	0.00055
Blastomonas sp. RAC04	1842535	S	260	4	264	0.00060
Agrobacterium sp. RAC06	1842536	S	120	0	120	0.00027
Hydrogenophaga sp. RAC07	1842537	S	291	23	314	0.00072
Frankia alni	1859	S	273	19	292	0.00067
Desulfovibrio aespoeensis	182210	S	23	6	29	0.00007
[Clostridium] saccharolyticum	84030	S	46	2	48	0.00011
Saccharomonospora viridis	1852	S	109	4	113	0.00026
Calothrix sp. 336/3	1337936	S	47	1	48	0.00011
Desulfosporosinus acidiphilus	885581	S	10	1	11	0.00003
Winogradskyella sp. PG-2	754409	S	16	0	16	0.00004
Nitrobacter winogradskyi	913	S	94	11	105	0.00024
Nitrobacter hamburgensis	912	S	130	16	146	0.00033
Pseudonocardia sp. HH130630-07	1690815	S	423	76	499	0.00114
Hymenobacter sp. PAMC 26628	1484118	S	1167	16	1183	0.00270
Hymenobacter sp. PAMC 26554	1484116	S	1484	10	1494	0.00341
Gilliamella apicola	1196095	S	10	0	10	0.00002
Fermentimonas caenicola	1562970	S	12	0	12	0.00003
Pseudomonas sp. DR 5-09	1534110	S	47	10	57	0.00013
Streptomyces scabiei	1930	S	202	19	221	0.00050
Microbacterium chocolatum	84292	S	570	53	623	0.00142
Halotalea alkalilenta	376489	S	55	0	55	0.00013
Rivularia sp. PCC 7116	373994	S	31	1	32	0.00007
Sphingomonas sp. NIC1	1167641	S	526	403	929	0.00212
Ochrobactrum pseudogrignonense	419475	S	34	0	34	0.00008
Bordetella petrii	94624	S	65	15	80	0.00018
Sandaracinus amylolyticus	927083	S	192	4	196	0.00045
Burkholderiales bacterium GJ-E10	1469502	S	57	1	58	0.00013
Desulfovibrio magneticus	184917	S	27	0	27	0.00006
Corallococcus coralloides	184914	S	100	17	117	0.00027
Acidovorax avenae	80867	S	153	28	181	0.00041
Delftia acidovorans	80866	S	40	65	105	0.00024
Caldilinea aerophila	133453	S	33	0	33	0.00008
Acidovorax citrulli	80869	S	136	27	163	0.00037
Lactobacillus helveticus	1587	S	174	108	282	0.00064
Streptococcus pasteurianus	197614	S	14	0	14	0.00003
Lysobacter capsici	435897	S	189	31	220	0.00050
Calothrix sp. PCC 7507	99598	S	120	9	129	0.00029
Candidatus Desulforudis audaxviator	471827	S	12	0	12	0.00003
Gallibacterium anatis	750	S	16	0	16	0.00004
Pseudomonas parafulva	157782	S	52	1	53	0.00012
Pseudomonas cremoricolorata	157783	S	47	1	48	0.00011
Thermothelomyces thermophila	78579	S	1420	330	1750	0.00399
Lactobacillus paracasei	1597	S	398	468	866	0.00198
Lactobacillus gasseri	1596	S	1387	29	1416	0.00323
Myxococcus hansupus	1297742	S	30	12	42	0.00010
Kurthia sp. 11kri321	1750719	S	17	1	18	0.00004
Leuconostoc citreum	33964	S	218	3	221	0.00050
Staphylococcus phage IME-SA4	1610872	S	55	3	58	0.00013
Bordetella trematum	123899	S	37	1	38	0.00009
Lactobacillus reuteri	1598	S	113	3	116	0.00026
Actinotignum schaalii	59505	S	30	0	30	0.00007
Staphylococcus pasteuri	45972	S	1136	76	1212	0.00276
Hoeflea sp. IMCC20628	1620421	S	71	0	71	0.00016
Pseudomonas corrugata	47879	S	36	1	37	0.00009
Pseudomonas azotoformans	47878	S	90	13	103	0.00024
Mycobacterium chubuense	1800	S	285	10	295	0.00067
Xylanimonas cellulosilytica	186189	S	313	21	334	0.00076
Streptomyces fulvissimus	68202	S	121	33	154	0.00035
Microbulbifer sp. CCB-MM1	1769779	S	12	0	12	0.00003
Variovorax paradoxus	34073	S	1561	86	1647	0.00375
Planococcus halocryophilus	1215089	S	10	2	12	0.00003
Microbacterium sp. PAMC 28756	1795053	S	566	74	640	0.00146
Psychrobacter sp. AntiMn-1	1720344	S	46	0	46	0.00011
Moraxella osloensis	34062	S	5120	29	5149	0.01173
Clostridium bornimense	1216932	S	12	2	14	0.00003
Rhizobium tropici	398	S	101	0	101	0.00023
Erythrobacter atlanticus	1648404	S	56	4	60	0.00014
Novosphingobium pentaromativorans	205844	S	56	87	143	0.00033
Sneathia amnii	187101	S	32	0	32	0.00007
Lachnoclostridium phytofermentans	66219	S	30	0	30	0.00007
Luteipulveratus mongoliensis	571913	S	456	10	466	0.00106
Clostridium baratii	1561	S	12	0	12	0.00003
Porphyrobacter neustonensis	1112	S	166	8	174	0.00040
Corynebacterium mustelae	571915	S	32	0	32	0.00007
Nostoc sp. PCC 7524	28072	S	64	7	71	0.00016
Amphibacillus xylanus	1449	S	12	0	12	0.00003
Streptomyces sp. SirexAA-E	862751	S	169	21	190	0.00043
Leptotrichia sp. oral taxon 212	712357	S	289	1	290	0.00066
Flavobacterium branchiophilum	55197	S	15	0	15	0.00004
Actinobacillus succinogenes	67854	S	11	0	11	0.00003
Neisseria meningitidis	487	S	1653	499	2152	0.00491
Neisseria lactamica	486	S	404	31	435	0.00099
Neisseria gonorrhoeae	485	S	319	53	372	0.00085
Acinetobacter oleivorans	1148157	S	39	2	41	0.00010
Halomonas chromatireducens	507626	S	27	0	27	0.00006
Moraxella catarrhalis	480	S	145	3	148	0.00034
Sphingomonas wittichii	160791	S	770	36	806	0.00184
Leisingera methylohalidivorans	133924	S	83	4	87	0.00020
Olsenella uli	133926	S	92	8	100	0.00023
Streptomyces pratensis	1169025	S	14	98	112	0.00026
Lactobacillus phage phiadh	12417	S	16	0	16	0.00004
Staphylococcus phage StB12	1147042	S	199	25	224	0.00051
Staphylococcus phage StB27	1147044	S	82	12	94	0.00021
Acinetobacter sp. BRTC-1	1789224	S	40	0	40	0.00009
Aureimonas sp. AU20	1349819	S	238	0	238	0.00054
Kineococcus radiotolerans	131568	S	528	26	554	0.00126
Niastella koreensis	354356	S	54	4	58	0.00013
Lactococcus Phage ASCC191	1165134	S	10	5	15	0.00004
Frankia symbiont of Datisca glomerata	656024	S	125	6	131	0.00030
Oceanimonas sp. GK1	511062	S	17	0	17	0.00004
Burkholderia multivorans	87883	S	87	26	113	0.00026
Komagataeibacter medellinensis	1177712	S	32	6	38	0.00009
Shewanella violacea	60217	S	16	2	18	0.00004
Methylobacterium radiotolerans	31998	S	152	527	679	0.00155
Blautia sp. YL58	1796616	S	111	0	111	0.00025
Bacteroides caecimuris	1796613	S	217	14	231	0.00053
Corynebacterium urealyticum	43771	S	239	54	293	0.00067
Arcanobacterium haemolyticum	28264	S	30	8	38	0.00009
Campylobacter concisus	199	S	63	0	63	0.00014
Campylobacter coli	195	S	809	94	903	0.00206
Campylobacter jejuni	197	S	84	33	117	0.00027
Campylobacter fetus	196	S	50	2	52	0.00012
Azospirillum lipoferum	193	S	348	86	434	0.00099
Azospirillum brasilense	192	S	430	21	451	0.00103
Rhodococcus aetherivorans	191292	S	29	86	115	0.00026
Methylobacterium sp. AMS5	925818	S	199	64	263	0.00060
Streptococcus sp. I-P16	1156433	S	123	16	139	0.00032
Streptococcus sp. I-G2	1156431	S	105	14	119	0.00027
Flavobacterium sp. PK15	1306519	S	107	6	113	0.00026
Methylobacterium sp. 4-46	426117	S	492	5	497	0.00113
Delftia sp. Cs1-4	742013	S	38	47	85	0.00020
Paraburkholderia sprentiae	948107	S	43	5	48	0.00011
Sideroxydans lithotrophicus	63745	S	28	0	28	0.00006
Megasphaera elsdenii	907	S	56	0	56	0.00013
Acidaminococcus fermentans	905	S	15	2	17	0.00004
Bradyrhizobium diazoefficiens	1355477	S	347	207	554	0.00126
Methanobacterium formicicum	2162	S	3047	2	3049	0.00695
Burkholderia seminalis	488731	S	29	13	42	0.00010
Burkholderia diffusa	488732	S	28	10	38	0.00009
Streptococcus phage SpSL1	1566990	S	11	0	11	0.00003
Streptomyces globisporus	1908	S	121	38	159	0.00036
Ralstonia insidiosa	190721	S	61	12	73	0.00017
Streptomyces glaucescens	1907	S	163	28	191	0.00044
Streptomyces coelicolor	1902	S	15	129	144	0.00033
Streptomyces clavuligerus	1901	S	140	10	150	0.00034
Fusobacterium nucleatum	851	S	738	27	765	0.00174
Beutenbergia cavernae	84757	S	292	6	298	0.00068
Desulfuromonas soudanensis	1603606	S	27	0	27	0.00006
Selenomonas sp. oral taxon 920	1884263	S	33	0	33	0.00008
Ferrimonas balearica	44012	S	12	0	12	0.00003
Elizabethkingia anophelis	1117645	S	40	11	51	0.00012
Pontibacter akesuensis	388950	S	19	1	20	0.00005
Verrucosispora maris	1003110	S	312	37	349	0.00080
Catenulispora acidiphila	304895	S	280	7	287	0.00065
Microbulbifer thermotolerans	252514	S	12	0	12	0.00003
Sphingobium japonicum	332056	S	180	59	239	0.00055
Burkholderia thailandensis	57975	S	47	49	96	0.00022
Deinococcus peraridilitoris	432329	S	22	0	22	0.00005
Bifidobacterium scardovii	158787	S	118	1	119	0.00027
Brachyspira murdochii	84378	S	12	2	14	0.00003
Pasteurella multocida	747	S	36	0	36	0.00008
Janthinobacterium sp. Marseille	375286	S	35	5	40	0.00009
Geitlerinema sp. PCC 7407	1173025	S	26	2	28	0.00006
Pseudomonas entomophila	312306	S	48	3	51	0.00012
Microcoleus sp. PCC 7113	1173027	S	109	7	116	0.00027
Komagataeibacter xylinus	28448	S	49	9	58	0.00013
Clavibacter michiganensis	28447	S	2209	236	2445	0.00557
[Clostridium] propionicum	28446	S	10	0	10	0.00002
Rhodococcus sp. B7740	1564114	S	384	17	401	0.00092
Pseudomonas rhizosphaerae	216142	S	258	3	261	0.00060
Microlunatus phosphovorus	29405	S	1131	28	1159	0.00264
Halorhodospira halophila	1053	S	43	0	43	0.00010
Bifidobacterium pseudolongum	1694	S	58	0	58	0.00013
Corynebacterium sp. NML98-0116	702967	S	357	19	376	0.00086
Kibdelosporangium phytohabitans	860235	S	259	12	271	0.00062
Mesorhizobium amorphae	71433	S	251	12	263	0.00060
Streptomyces sp. CdTB01	1725411	S	225	29	254	0.00058
Marinithermus hydrothermalis	186192	S	16	0	16	0.00004
Streptomyces griseochromogenes	68214	S	130	20	150	0.00034
Rhodospirillum centenum	34018	S	176	6	182	0.00042
Micrococcus luteus	1270	S	3999	453	4452	0.01015
Dermacoccus nishinomiyaensis	1274	S	362	34	396	0.00090
Kytococcus sedentarius	1276	S	3050	369	3419	0.00779
Serratia marcescens	615	S	92	78	170	0.00039
Acidovorax ebreus	721785	S	44	74	118	0.00027
Emticicia oligotrophica	312279	S	10	0	10	0.00002
Flavobacterium indicum	312277	S	25	0	25	0.00006
Oceanithermus profundus	187137	S	38	0	38	0.00009
Acidothermus cellulolyticus	28049	S	54	0	54	0.00012
Sporosarcina psychrophila	1476	S	11	0	11	0.00003
Serratia fonticola	47917	S	29	0	29	0.00007
Bacillus simplex	1478	S	25	0	25	0.00006
Streptococcus salivarius	1304	S	795	13	808	0.00184
Streptococcus sanguinis	1305	S	2363	14	2377	0.00542
Bibersteinia trehalosi	47735	S	20	0	20	0.00005
Streptococcus gordonii	1302	S	1514	23	1537	0.00350
Streptococcus oralis	1303	S	6207	103	6310	0.01438
Streptococcus thermophilus	1308	S	455	14	469	0.00107
Streptococcus mutans	1309	S	271	1	272	0.00062
Neisseria elongata	495	S	1006	16	1022	0.00233
Brevundimonas sp. DS20	1532555	S	395	52	447	0.00102
Streptococcus phage EJ-1	12402	S	54	3	57	0.00013
Devriesea agamarum	472569	S	32	0	32	0.00007
Deinococcus deserti	310783	S	24	0	24	0.00006
Burkholderia sp. RPE67	758796	S	22	23	45	0.00010
Flammeovirgaceae bacterium 311	1257021	S	15	0	15	0.00003
Planococcus antarcticus	161360	S	52	4	56	0.00013
Nocardioides sp. JS614	196162	S	1866	123	1989	0.00453
Paenibacillus bovis	1616788	S	10	0	10	0.00002
Flavobacterium sp. LPB0076	1763534	S	36	3	39	0.00009
Hydrogenophaga sp. LPB0072	1763535	S	51	1	52	0.00012
Prevotella melaninogenica	28132	S	380	24	404	0.00092
Prevotella intermedia	28131	S	144	13	157	0.00036
'Deinococcus soli' Cha et al. 2014	1309411	S	38	18	56	0.00013
Mycobacterium sp. VKM Ac-1817D	1273687	S	28	99	127	0.00029
Xanthomonas fuscans	366648	S	21	6	27	0.00006
Moorea producens	1155739	S	61	3	64	0.00015
Microterricola viridarii	412690	S	438	28	466	0.00106
Azorhizobium caulinodans	7	S	152	6	158	0.00036
Sulfuricella denitrificans	649841	S	20	0	20	0.00005
Corynebacterium glyciniphilum	1404244	S	60	1	61	0.00014
Pseudomonas knackmussii	65741	S	65	5	70	0.00016
Nitrosomonas sp. Is79A3	261292	S	17	5	22	0.00005
Bradyrhizobium sp. ORS 278	114615	S	266	25	291	0.00066
Jeongeupia sp. USM3	1906741	S	74	1	75	0.00017
Microbacterium sp. BH3-3-3	1906742	S	750	127	877	0.00200
Methylobacterium nodulans	114616	S	398	3	401	0.00091
Terriglobus saanensis	870903	S	19	0	19	0.00004
Paraburkholderia rhizoxinica	412963	S	24	0	24	0.00006
Xylella fastidiosa	2371	S	17	0	17	0.00004
Celeribacter marinus	1397108	S	15	0	15	0.00003
Burkholderia oklahomensis	342113	S	62	11	73	0.00017
Actinoplanes sp. SE50/110	134676	S	414	49	463	0.00106
Sphingopyxis fribergensis	1515612	S	338	68	406	0.00093
Psychrobacter alimentarius	261164	S	53	0	53	0.00012
Selenomonas ruminantium	971	S	12	0	12	0.00003
Mitsuaria sp. 7	1658665	S	287	27	314	0.00072
Streptomyces sampsonii	42239	S	21	168	189	0.00043
Cellulophaga lytica	979	S	12	0	12	0.00003
Stackebrandtia nassauensis	283811	S	162	2	164	0.00037
Castellaniella defragrans	75697	S	83	5	88	0.00020
Rufibacter sp. DG31D	1379910	S	22	0	22	0.00005
Methylobacterium aquaticum	270351	S	747	9	756	0.00172
Mucilaginibacter sp. PAMC 26640	1300914	S	75	1	76	0.00017
Burkholderia metallica	488729	S	11	13	24	0.00006
Arthrobacter sp. IHBB 11108	1618207	S	37	0	37	0.00009
Dyella japonica	231455	S	82	11	93	0.00021
Streptomyces griseus	1911	S	137	37	174	0.00040
Streptomyces hygroscopicus	1912	S	195	28	223	0.00051
Streptomyces lincolnensis	1915	S	186	22	208	0.00048
Bordetella pseudohinzii	1331258	S	47	6	53	0.00012
Streptomyces lividans	1916	S	17	194	211	0.00048
Terriglobus roseus	392734	S	83	2	85	0.00020
Paraburkholderia caribensis	75105	S	115	11	126	0.00029
Eremothecium gossypii	33169	S	80	662	742	0.00169
Achromobacter xylosoxidans	85698	S	238	94	332	0.00076
Thermomonospora curvata	2020	S	272	11	283	0.00065
Thermobifida fusca	2021	S	104	4	108	0.00025
Acinetobacter sp. ADP1	62977	S	59	0	59	0.00014
Carnobacterium maltaromaticum	2751	S	57	0	57	0.00013
Sphingomonas melonis	152682	S	573	354	927	0.00211
Intestinimonas butyriciproducens	1297617	S	153	6	159	0.00036
Rhodococcus sp. PBTS 2	1653479	S	301	157	458	0.00105
Rhodococcus sp. PBTS 1	1653478	S	260	17	277	0.00063
Nakamurella multipartita	53461	S	498	17	515	0.00117
Molluscum contagiosum virus	10279	S	27	0	27	0.00006
Jannaschia sp. CCS1	290400	S	53	0	53	0.00012
Lawsonella clevelandensis	1528099	S	417	19	436	0.00099
Azoarcus olearius	418699	S	11	30	41	0.00009
Azospirillum thiophilum	528244	S	184	38	222	0.00051
Streptomyces cyaneogriseus	68192	S	46	56	102	0.00023
Deinococcus swuensis	1182571	S	132	1	133	0.00030
Pseudomonas brassicacearum	930166	S	71	10	81	0.00019
Massilia sp. NR 4-1	1678028	S	203	17	220	0.00050
Candidatus Nitrospira inopinata	1715989	S	15	0	15	0.00004
Burkholderia pseudomallei	28450	S	176	189	365	0.00083
Streptomyces avermitilis	33903	S	193	21	214	0.00049
Verminephrobacter eiseniae	364317	S	133	4	137	0.00031
Bifidobacterium thermophilum	33905	S	32	0	32	0.00007
Pectobacterium atrosepticum	29471	S	16	3	19	0.00004
Allochromatium vinosum	1049	S	28	0	28	0.00007
Micromonospora aurantiaca	47850	S	78	187	265	0.00061
Bifidobacterium bifidum	1681	S	430	41	471	0.00107
Bifidobacterium adolescentis	1680	S	440	20	460	0.00105
Bifidobacterium angulatum	1683	S	37	0	37	0.00009
Bifidobacterium breve	1685	S	76	27	103	0.00024
Bifidobacterium asteroides	1684	S	21	0	21	0.00005
Bifidobacterium catenulatum	1686	S	35	6	41	0.00009
Bifidobacterium dentium	1689	S	34	0	34	0.00008
Confluentimicrobium sp. EMB200-NS6	1609966	S	116	34	150	0.00034
Aliivibrio fischeri	668	S	10	0	10	0.00002
Paracoccus aminophilus	34003	S	171	9	180	0.00041
Finegoldia magna	1260	S	1047	6	1053	0.00240
Weissella cibaria	137591	S	21	1	22	0.00005
Ruminococcus albus	1264	S	22	0	22	0.00005
Collimonas pratensis	279113	S	68	9	77	0.00018
Altererythrobacter dongtanensis	692370	S	231	5	236	0.00054
Acidiphilium cryptum	524	S	21	68	89	0.00020
Verrucomicrobia bacterium L21-Fru-AB	1609981	S	15	0	15	0.00003
Helicobacter pylori	210	S	12	2	14	0.00003
Streptococcus pyogenes	1314	S	221	157	378	0.00086
Streptococcus pneumoniae	1313	S	6862	1689	8551	0.01948
Wenyingzhuangia fucanilytica	1790137	S	11	0	11	0.00003
Streptococcus agalactiae	1311	S	247	4	251	0.00057
Asaia bogorensis	91915	S	22	0	22	0.00005
Streptococcus parasanguinis	1318	S	695	6	701	0.00160
Phycisphaera mikurensis	547188	S	66	0	66	0.00015
Selenomonas sp. oral taxon 478	712538	S	21	9	30	0.00007
Paucibacter sp. KCTC 42545	1768242	S	78	6	84	0.00019
Corynebacterium sp. ATCC 6931	1487956	S	274	16	290	0.00066
Tannerella sp. oral taxon HOT-286	712710	S	80	1	81	0.00019
Pseudomonas syringae	317	S	419	77	496	0.00113
Pseudomonas stutzeri	316	S	547	30	577	0.00132
Kutzneria albida	43357	S	328	22	350	0.00080
Cyanothece sp. PCC 7822	497965	S	10	1	11	0.00003
Streptococcus constellatus	76860	S	72	0	72	0.00016
Thiocystis violascens	73141	S	31	0	31	0.00007
Prevotella denticola	28129	S	123	7	130	0.00030
Gluconobacter oxydans	442	S	47	5	52	0.00012
Methylocystis sp. SC2	187303	S	92	0	92	0.00021
Porphyromonas asaccharolytica	28123	S	2045	6	2051	0.00467
Phaeobacter gallaeciensis	60890	S	94	9	103	0.00024
Thermobaculum terrenum	166501	S	16	0	16	0.00004
Nostoc sp. NIES-3756	1751286	S	166	18	184	0.00042
[Polyangium] brachysporum	413882	S	213	12	225	0.00051
Desulfovibrio vulgaris	881	S	63	1	64	0.00015
Crinalium epipsammum	241425	S	227	21	248	0.00057
Candidatus Puniceispirillum marinum	767892	S	10	0	10	0.00002
Dyadobacter fermentans	94254	S	83	1	84	0.00019
Thioflavicoccus mobilis	80679	S	49	0	49	0.00011
endosymbiont of unidentified scaly snail isolate Monju	1248727	S	28	0	28	0.00007
Plautia stali symbiont	891974	S	18	0	18	0.00004
Anaeromyxobacter sp. Fw109-5	404589	S	136	6	142	0.00032
Spirosoma radiotolerans	1379870	S	298	2	300	0.00068
Geodermatophilus obscurus	1861	S	950	83	1033	0.00236
Ottowia sp. oral taxon 894	1658672	S	64	1	65	0.00015
Arsenicicoccus sp. oral taxon 190	1658671	S	661	67	728	0.00166
Streptomyces sp. S10(2016)	1783515	S	153	21	174	0.00040
Truepera radiovictrix	332249	S	84	0	84	0.00019
Herbaspirillum seropedicae	964	S	103	16	119	0.00027
Gordonia sp. KTR9	337191	S	216	20	236	0.00054
Streptococcus gallolyticus	315405	S	22	13	35	0.00008
Myxococcus fulvus	33	S	119	40	159	0.00036
Rufibacter sp. DG15C	1379909	S	13	0	13	0.00003
Opitutaceae bacterium IG16b	1838286	S	140	6	146	0.00033
Microbacterium sp. XT11	367477	S	418	44	462	0.00105
Desulfovibrio desulfuricans	876	S	45	8	53	0.00012
Elizabethkingia miricola	172045	S	30	4	34	0.00008
Dichelobacter nodosus	870	S	20	0	20	0.00005
Anabaena sp. wa102	1647413	S	34	29	63	0.00014
Marinobacter hydrocarbonoclasticus	2743	S	14	19	33	0.00008
Microbacterium testaceum	2033	S	507	69	576	0.00131
Ralstonia mannitolilytica	105219	S	96	23	119	0.00027
Halomonas elongata	2746	S	35	0	35	0.00008
Buchnera aphidicola	9	S	50	0	50	0.00011
Aeromonas salmonicida	645	S	25	1	26	0.00006
Aeromonas hydrophila	644	S	128	16	144	0.00033
Desulfobulbus propionicus	894	S	14	0	14	0.00003
Desulfococcus multivorans	897	S	11	1	12	0.00003
Desulfomicrobium baculatum	899	S	21	2	23	0.00005
Pusillimonas sp. T7-7	1007105	S	15	0	15	0.00004
Mesorhizobium ciceri	39645	S	202	45	247	0.00056
Enterobacter sp. 638	399742	S	19	0	19	0.00004
Cotesia congregata bracovirus	39640	S	118	0	118	0.00027
Corynebacterium maris	575200	S	234	5	239	0.00055
Anaerolinea thermophila	167964	S	18	0	18	0.00004
Marinomonas sp. MWYL1	400668	S	16	1	17	0.00004
Alcanivorax dieselolei	285091	S	26	2	28	0.00006
Granulibacter bethesdensis	364410	S	57	0	57	0.00013
Burkholderia pseudomultivorans	1207504	S	15	15	30	0.00007
Anoxybacillus flavithermus	33934	S	21	11	32	0.00007
Mycobacterium marinum	1781	S	41	99	140	0.00032
Wenzhouxiangella marina	1579979	S	29	0	29	0.00007
Acidiphilium multivorum	62140	S	29	85	114	0.00026
Raoultella ornithinolytica	54291	S	54	0	54	0.00012
Bacteroides helcogenes	290053	S	153	0	153	0.00035
Chlorobaculum limnaeum	274537	S	19	1	20	0.00005
Chroococcidiopsis thermalis	54299	S	65	4	69	0.00016
Dermabacter vaginalis	1630135	S	173	68	241	0.00055
Lysinibacillus varians	1145276	S	11	6	17	0.00004
Veillonella parvula	29466	S	1904	2	1906	0.00434
Blastochloris viridis	1079	S	173	2	175	0.00040
Rhodopseudomonas palustris	1076	S	1307	82	1389	0.00317
Hyphomicrobium nitrativorans	1427356	S	99	1	100	0.00023
Chlorobaculum tepidum	1097	S	12	1	13	0.00003
Vibrio fluvialis	676	S	12	5	17	0.00004
Vibrio parahaemolyticus	670	S	14	12	26	0.00006
Alkalilimnicola ehrlichii	351052	S	39	0	39	0.00009
Alloactinosynnema sp. L-07	1653480	S	306	26	332	0.00076
Steroidobacter denitrificans	465721	S	31	0	31	0.00007
Sphingomonas hengshuiensis	1609977	S	890	6	896	0.00204
Chitinophaga pinensis	79329	S	31	2	33	0.00008
Bacillus cellulosilyticus	1413	S	11	0	11	0.00003
Geoalkalibacter subterraneus	483547	S	10	4	14	0.00003
Sphingorhabdus sp. M41	1806885	S	81	0	81	0.00019
Streptobacillus moniliformis	34105	S	22	0	22	0.00005
Staphylococcus pseudintermedius	283734	S	98	3	101	0.00023
Lactobacillus rhamnosus	47715	S	19	3	22	0.00005
Streptococcus anginosus	1328	S	314	21	335	0.00076
Lacimicrobium alkaliphilum	1526571	S	11	0	11	0.00003
Mesorhizobium opportunistum	593909	S	177	81	258	0.00059
Persicobacter sp. JZB09	1085624	S	13	0	13	0.00003
Clostridium beijerinckii	1520	S	12	26	38	0.00009
Rahnella aquatilis	34038	S	21	102	123	0.00028
Caulobacter segnis	88688	S	193	32	225	0.00051
Nostoc sp. PCC 7120	103690	S	137	28	165	0.00038
Klebsiella michiganensis	1134687	S	303	295	598	0.00136
Pseudomonas mendocina	300	S	294	8	302	0.00069
Pseudomonas putida	303	S	459	195	654	0.00149
Corynebacterium lactis	1231000	S	86	3	89	0.00020
Ralstonia solanacearum	305	S	229	23	252	0.00058
Solibacillus silvestris	76853	S	16	0	16	0.00004
Octadecabacter antarcticus	1217908	S	12	2	14	0.00003
Fusobacterium hwasookii	1583098	S	252	31	283	0.00065
Jeotgalibacillus malaysiensis	1508404	S	14	0	14	0.00003
Corynebacterium vitaeruminis	38305	S	285	15	300	0.00068
Acidihalobacter prosperus	160660	S	13	0	13	0.00003
Thielavia terrestris	35720	S	729	268	997	0.00227
Streptomyces pristinaespiralis	38300	S	185	17	202	0.00046
Olsenella sp. oral taxon 807	712411	S	76	7	83	0.00019
Serratia proteamaculans	28151	S	12	0	12	0.00003
Enterobacter sp. FY-07	1692238	S	12	0	12	0.00003
Flavonifractor plautii	292800	S	234	8	242	0.00055
Pedobacter sp. PACM 27299	1727164	S	54	13	67	0.00015
Pseudomonas frederiksbergensis	104087	S	26	1	27	0.00006
Citrobacter amalonaticus	35703	S	40	0	40	0.00009
Aromatoleum aromaticum	551760	S	85	4	89	0.00020
Pedobacter steynii	430522	S	73	12	85	0.00019
Streptomyces sp. RTd22	1841249	S	208	14	222	0.00051
Streptomyces sp. 4F	1751294	S	191	29	220	0.00050
Bordetella hinzii	103855	S	69	10	79	0.00018
Methylomicrobium alcaliphilum	271065	S	16	0	16	0.00004
Alistipes finegoldii	214856	S	226	9	235	0.00054
Burkholderia pyrrocinia	60550	S	20	9	29	0.00007
Burkholderia vietnamiensis	60552	S	25	147	172	0.00039
Geobacter uraniireducens	351604	S	18	0	18	0.00004
Gloeobacter kilaueensis	1416614	S	36	4	40	0.00009
Deinococcus actinosclerus	1768108	S	49	24	73	0.00017
Methylomonas denitrificans	1538553	S	19	0	19	0.00004
Enterobacteria phage phiX174 sensu lato	374840	S	169	0	169	0.00039
Croceicoccus naphthovorans	1348774	S	101	65	166	0.00038
Streptomyces sp. 769	1262452	S	58	63	121	0.00028
Streptomyces sp. PAMC 26508	1265601	S	25	176	201	0.00046
Haliscomenobacter hydrossis	2350	S	21	0	21	0.00005
Pantoea vagans	470934	S	37	1	38	0.00009
Bdellovibrio bacteriovorus	959	S	20	0	20	0.00005
Nitrospira moscoviensis	42253	S	39	1	40	0.00009
Rubrobacter radiotolerans	42256	S	79	1	80	0.00018
Novosphingobium resinovorum	158500	S	457	38	495	0.00113
Stenotrophomonas acidaminiphila	128780	S	221	50	271	0.00062
Lactobacillus kefiranofaciens	267818	S	35	2	37	0.00009
Herminiimonas arsenicoxydans	204773	S	43	12	55	0.00013
Erwinia billingiae	182337	S	102	8	110	0.00025
Pseudomonas poae	200451	S	200	12	212	0.00048
Pseudomonas trivialis	200450	S	101	10	111	0.00025
Corynebacterium efficiens	152794	S	191	8	199	0.00045
Halobacterium sp. DL1	751944	S	13	12	25	0.00006
Microbacterium sp. CGR1	1696072	S	648	57	705	0.00161
Phenylobacterium zucineum	284016	S	477	9	486	0.00111
Streptosporangium roseum	2001	S	415	18	433	0.00099
Thermobispora bispora	2006	S	264	5	269	0.00061
Mannheimia sp. USDA-ARS-USMARC-1261	1432056	S	19	5	24	0.00005
Rhizobium sp. S41	1869170	S	102	2	104	0.00024
Stenotrophomonas rhizophila	216778	S	175	38	213	0.00049
Acinetobacter pittii	48296	S	120	7	127	0.00029
Arthrobacter sp. Rue61a	1118963	S	27	90	117	0.00027
Chelatococcus sp. CO-6	1702325	S	321	0	321	0.00073
Rhodopirellula baltica	265606	S	10	0	10	0.00002
Desulfovibrio sp. J2	1716143	S	21	4	25	0.00006
Rufibacter tibetensis	512763	S	18	0	18	0.00004
Pantoea sp. PSNIH2	1484157	S	23	3	26	0.00006
Pantoea sp. PSNIH1	1484158	S	16	1	17	0.00004
Anaerococcus prevotii	33034	S	1089	13	1102	0.00251
Parvimonas micra	33033	S	71	0	71	0.00016
Pseudomonas chlororaphis	587753	S	178	37	215	0.00049
Stanieria cyanosphaera	102116	S	24	1	25	0.00006
Rhodococcus opacus	37919	S	402	63	465	0.00106
Actinobacillus equuli	718	S	13	5	18	0.00004
Actinobacillus suis	716	S	17	8	25	0.00006
Actinobacillus pleuropneumoniae	715	S	24	5	29	0.00007
Aggregatibacter actinomycetemcomitans	714	S	52	0	52	0.00012
Rhodomicrobium vannielii	1069	S	79	0	79	0.00018
Borrelia duttonii	40834	S	22	13	35	0.00008
Defluviimonas alba	1335048	S	308	34	342	0.00078
Rhodobacter capsulatus	1061	S	142	6	148	0.00034
Rhodobacter sphaeroides	1063	S	823	23	846	0.00193
Trueperella pyogenes	1661	S	48	2	50	0.00012
Rhodospirillum rubrum	1085	S	86	0	86	0.00020
Pararhodospirillum photometricum	1084	S	51	2	53	0.00012
Curtobacterium sp. BH-2-1-1	1905847	S	879	90	969	0.00221
Methanobrevibacter sp. YE315	1609968	S	13	2	15	0.00003
Streptococcus mitis	28037	S	20583	791	21374	0.04870
Cellulophaga baltica	76594	S	13	0	13	0.00003
Staphylococcus lugdunensis	28035	S	478	8	486	0.00111
Halomonas sp. KO116	1504981	S	13	0	13	0.00003
Lactobacillus curvatus	28038	S	413	10	423	0.00097
Polymorphum gilvum	991904	S	176	0	176	0.00040
Leclercia adecarboxylata	83655	S	18	0	18	0.00004
Bacillus pumilus	1408	S	20	0	20	0.00005
Paenibacillus polymyxa	1406	S	14	32	46	0.00011
Bacillus megaterium	1404	S	16	1	17	0.00004
Streptococcus intermedius	1338	S	226	12	238	0.00054
Streptococcus dysgalactiae	1334	S	82	18	100	0.00023
Streptomyces lydicus	47763	S	338	48	386	0.00088
Streptococcus equi	1336	S	34	0	34	0.00008
Polaromonas sp. JS666	296591	S	164	7	171	0.00039
Acholeplasma brassicae	61635	S	22	3	25	0.00006
Myxococcus xanthus	34	S	41	23	64	0.00015
Bradyrhizobium sp. BTAi1	288000	S	257	21	278	0.00063
Flavobacteriaceae bacterium 3519-10	531844	S	56	0	56	0.00013
Altererythrobacter namhicola	645517	S	119	2	121	0.00028
Clostridium kluyveri	1534	S	12	0	12	0.00003
Leuconostoc mesenteroides	1245	S	65	5	70	0.00016
Leuconostoc gelidum	1244	S	23	0	23	0.00005
Pseudomonas antarctica	219572	S	62	3	65	0.00015
Leptothrix cholodnii	34029	S	325	33	358	0.00082
Xanthomonas campestris	339	S	689	90	779	0.00178
Burkholderia glumae	337	S	84	44	128	0.00029
Pseudomonas pseudoalcaligenes	330	S	1354	231	1585	0.00361
Psychrobacter arcticus	334543	S	41	0	41	0.00010
Niabella soli	446683	S	21	5	26	0.00006
Corynebacterium kutscheri	35755	S	23	0	23	0.00005
Muricauda ruestringensis	111501	S	10	0	10	0.00002
Klebsiella variicola	244366	S	20	38	58	0.00013
Advenella kashmirensis	310575	S	35	1	36	0.00008
Pseudanabaena sp. PCC 7367	82654	S	79	2	81	0.00019
Frateuria aurantia	81475	S	40	2	42	0.00010
Flavobacterium psychrophilum	96345	S	526	12	538	0.00123
Streptococcus marmotae	1825069	S	14	0	14	0.00003
Pantoea sp. At-9b	592316	S	12	0	12	0.00003
Corynebacterium ureicelerivorans	401472	S	4100	313	4413	0.01006
Rathayibacter toxicus	145458	S	57	2	59	0.00014
Alteromonas mediterranea	314275	S	3718	332	4050	0.00923
Planococcus rifietoensis	200991	S	10	2	12	0.00003
Streptomyces ambofaciens	1889	S	143	41	184	0.00042
Streptomyces albus	1888	S	234	377	611	0.00139
Salmonella enterica	28901	S	403	618	1021	0.00233
Sphingopyxis alaskensis	117207	S	256	17	273	0.00062
Ehrlichia canis	944	S	10	0	10	0.00002
Burkholderia ubonensis	101571	S	84	67	151	0.00035
Sphingomonas sp. MM-1	745310	S	501	167	668	0.00152
Paraburkholderia fungorum	134537	S	44	6	50	0.00012
Paraburkholderia xenovorans	36873	S	64	13	77	0.00018
Sphingobium sp. TKS	1315974	S	160	63	223	0.00051
Oscillatoria nigro-viridis	482564	S	1643	59	1702	0.00388
Streptomyces leeuwenhoekii	1437453	S	62	71	133	0.00030
Propionibacterium sp. oral taxon 193	671223	S	64	3	67	0.00015
Thermus oshimai	56957	S	10	0	10	0.00002
Parvularcula bermudensis	208216	S	11	0	11	0.00003
Magnetospirillum magneticum	84159	S	85	11	96	0.00022
Nocardiopsis dassonvillei	2014	S	249	20	269	0.00061
Nocardia cyriacigeorgica	135487	S	142	16	158	0.00036
Pseudomonas protegens	380021	S	102	8	110	0.00025
Actinobacteria bacterium IMCC26256	1650658	S	24	0	24	0.00005
Pseudomonas mosselii	78327	S	34	11	45	0.00010
Mageeibacillus indolicus	884684	S	45	0	45	0.00010
Clostridium sp. SY8519	1042156	S	53	1	54	0.00012
Plesiomonas shigelloides	703	S	11	0	11	0.00003
Pseudomonas sp. TCU-HL1	1856685	S	67	1	68	0.00016
Synechococcus sp. PCC 7502	1173263	S	15	0	15	0.00004
Bacillus infantis	324767	S	15	0	15	0.00003
Rhizobium etli	29449	S	180	6875	7055	0.01608
Thermus scotoductus	37636	S	38	1	39	0.00009
Xanthomonas albilineans	29447	S	65	1	66	0.00015
Polaribacter sp. MED152	313598	S	18	0	18	0.00004
Proteus mirabilis	584	S	10	16	26	0.00006
Morganella morganii	582	S	13	0	13	0.00003
Prevotella enoeca	76123	S	161	13	174	0.00040
Pseudomonas oryzihabitans	47885	S	1854	14	1868	0.00426
Bifidobacterium pseudocatenulatum	28026	S	196	21	217	0.00049
Pseudomonas fulva	47880	S	78	1	79	0.00018
Corynebacterium simulans	146827	S	1543	192	1735	0.00395
Cupriavidus basilensis	68895	S	98	5	103	0.00024
Cryobacterium arcticum	670052	S	595	32	627	0.00143
Listeria monocytogenes	1639	S	31	6	37	0.00008
Treponema sp. OMZ 838	1539298	S	11	1	12	0.00003
Streptococcus parauberis	1348	S	16	0	16	0.00004
Streptococcus uberis	1349	S	16	0	16	0.00004
Streptococcus iniae	1346	S	17	0	17	0.00004
Pseudomonas sp. L10.10	1788301	S	25	1	26	0.00006
Opitutaceae bacterium TAV5	794903	S	67	2	69	0.00016
Eubacterium limosum	1736	S	39	1	40	0.00009
Streptococcus pseudopneumoniae	257758	S	2336	147	2483	0.00566
Thermus parvatiensis	456163	S	14	16	30	0.00007
Paenibacillus mucilaginosus	61624	S	32	0	32	0.00007
Clostridium perfringens	1502	S	36	0	36	0.00008
Aeromonas veronii	654	S	36	4	40	0.00009
Clostridium pasteurianum	1501	S	19	11	30	0.00007
Aeromonas schubertii	652	S	29	1	30	0.00007
Aeromonas media	651	S	18	3	21	0.00005
Eggerthella sp. YY7918	502558	S	22	3	25	0.00006
Odoribacter splanchnicus	28118	S	81	2	83	0.00019
Rhodococcus sp. 008	1723645	S	381	115	496	0.00113
Aerococcus christensenii	87541	S	25	0	25	0.00006
Stenotrophomonas sp. LM091	1904944	S	269	73	342	0.00078
Pseudonocardia sp. HH130629-09	1641402	S	298	88	386	0.00088
Acetobacter senegalensis	446692	S	13	2	15	0.00003
Haloferax gibbonsii	35746	S	12	7	19	0.00004
Cupriavidus necator	106590	S	179	21	200	0.00046
Deinococcus proteolyticus	55148	S	101	1	102	0.00023
Ensifer adhaerens	106592	S	170	4	174	0.00040
Hafnia alvei	569	S	13	2	15	0.00003
Hoyosella subflava	639313	S	46	0	46	0.00011
Caulobacter sp. K31	366602	S	330	26	356	0.00081
Oblitimonas alkaliphila	1697053	S	29	0	29	0.00007
Actinomyces oris	544580	S	2853	207	3060	0.00697
Halobacterium hubeiense	1407499	S	15	3	18	0.00004
Ralstonia pickettii	329	S	175	43	218	0.00050
Sphingopyxis sp. 113P3	292913	S	162	19	181	0.00041
Listeria welshimeri	1643	S	12	0	12	0.00003
Corynebacterium singulare	161899	S	1231	127	1358	0.00310
Corynebacterium camporealensis	161896	S	686	26	712	0.00162
Arthrobacter alpinus	656366	S	132	6	138	0.00032
Staphylococcus phage phiRS7	1403390	S	27	0	27	0.00006
Aerococcus urinaeequi	51665	S	285	21	306	0.00070
Tetragenococcus halophilus	51669	S	37	0	37	0.00009
Marinobacterium sp. ST58-10	1821621	S	21	0	21	0.00005
Lactobacillus plantarum	1590	S	40	14	54	0.00012
Frankia casuarinae	106370	S	98	8	106	0.00024
Turicibacter sp. H121	1712675	S	51	0	51	0.00012
Corynebacterium kroppenstedtii	161879	S	49	1	50	0.00011
Burkholderia territorii	1503055	S	27	10	37	0.00009
Burkholderia stagnalis	1503054	S	56	13	69	0.00016
Rothia mucilaginosa	43675	S	1926	79	2005	0.00457
Jonesia denitrificans	43674	S	19	0	19	0.00005
Magnetospira sp. QH-2	1288970	S	39	0	39	0.00009
Lactobacillus sakei	1599	S	232	3	235	0.00054
Pseudomonas sp. GR 6-02	1659194	S	57	3	60	0.00014
Desulfurivibrio alkaliphilus	427923	S	13	0	13	0.00003
Solitalea canadensis	995	S	19	0	19	0.00004
Corynebacterium marinum	349751	S	240	16	256	0.00058
Flavobacterium columnare	996	S	34	1	35	0.00008
Flexibacter litoralis	999	S	10	0	10	0.00002
Thiobacillus denitrificans	36861	S	48	0	48	0.00011
Planctopirus limnophila	120	S	22	0	22	0.00005
Pirellula staleyi	125	S	32	0	32	0.00007
Isosphaera pallida	128	S	25	0	25	0.00006
Burkholderia ambifaria	152480	S	45	13	58	0.00013
Serinicoccus sp. JLT9	1758689	S	597	29	626	0.00143
Staphylococcus schleiferi	1295	S	94	0	94	0.00022
Hyphomicrobium denitrificans	53399	S	86	4	90	0.00021
Tsukamurella paurometabola	2061	S	371	14	385	0.00088
Kitasatospora setae	2066	S	279	30	309	0.00071
Staphylococcus agnetis	985762	S	93	2	95	0.00022
Cutibacterium avidum	33010	S	205	14	219	0.00050
Burkholderia cenocepacia	95486	S	76	219	295	0.00067
Burkholderia stabilis	95485	S	26	11	37	0.00008
Mycobacterium canettii	78331	S	10	89	99	0.00023
Pseudonocardia sp. AL041005-10	445576	S	334	51	385	0.00088
Geobacter anodireducens	1340425	S	17	9	26	0.00006
Thermosynechococcus elongatus	146786	S	54	3	57	0.00013
Azoarcus sp. CIB	198107	S	82	3	85	0.00019
Methylotenera versatilis	1055487	S	17	1	18	0.00004
Bradyrhizobium sp. CCGE-LA001	1223566	S	223	21	244	0.00056
Dehalogenimonas lykanthroporepellens	552810	S	10	0	10	0.00002
Shewanella oneidensis	70863	S	11	6	17	0.00004
Renibacterium salmoninarum	1646	S	14	0	14	0.00003
Corynebacterium casei	160386	S	281	32	313	0.00071
Streptomyces cattleya	29303	S	223	14	237	0.00054
Erysipelothrix rhusiopathiae	1648	S	18	0	18	0.00004
Ruegeria mobilis	379347	S	26	3	29	0.00007
Marichromatium purpuratum	37487	S	50	1	51	0.00012
Staphylococcus phage Ipla7	1197953	S	16	14	30	0.00007
Nocardia nova	37330	S	135	7	142	0.00032
Nocardia seriolae	37332	S	170	10	180	0.00041
Klebsiella pneumoniae	573	S	687	1287	1974	0.00450
Klebsiella oxytoca	571	S	2082	467	2549	0.00581
Coriobacterium glomerans	33871	S	22	0	22	0.00005
Pelobacter propionicus	29543	S	27	1	28	0.00007
Streptomyces albulus	68570	S	168	39	207	0.00047
Rhodothermus marinus	29549	S	45	1	46	0.00010
Bacillus thuringiensis	1428	S	32	28	60	0.00014
Histophilus somni	731	S	14	0	14	0.00003
[Haemophilus] ducreyi	730	S	31	0	31	0.00007
Aggregatibacter aphrophilus	732	S	1548	15	1563	0.00356
[Haemophilus] parasuis	738	S	33	0	33	0.00008
Roseateles depolymerans	76731	S	117	13	130	0.00030
Lactococcus lactis	1358	S	999	54	1053	0.00240
Enterococcus faecium	1352	S	52	26	78	0.00018
Enterococcus faecalis	1351	S	75	5	80	0.00018
Ruegeria pomeroyi	89184	S	101	3	104	0.00024
Enterococcus hirae	1354	S	16	0	16	0.00004
Streptococcus phage PH10	644007	S	17	0	17	0.00004
Arthrobacter sp. U41	1849032	S	274	11	285	0.00065
Parvibaculum lavamentivorans	256618	S	80	1	81	0.00019
Leuconostoc sp. C2	979982	S	13	17	30	0.00007
Sphingopyxis granuli	267128	S	342	95	437	0.00100
Acetoanaerobium sticklandii	1511	S	14	0	14	0.00003
Clostridium tetani	1513	S	22	0	22	0.00005
Actinoalloteichus hymeniacidonis	340345	S	104	3	107	0.00025
Agromyces sp. AR33	453304	S	761	51	812	0.00185
Streptomyces sp. Mg1	465541	S	244	20	264	0.00060
Mycobacterium chimaera	222805	S	32	80	112	0.00026
Saccharothrix espanaensis	103731	S	311	41	352	0.00080
Massilia sp. WG5	1707785	S	476	48	524	0.00120
Nitrosospira briensis	35799	S	27	0	27	0.00006
Kribbella flavida	182640	S	705	24	729	0.00166
Bordetella sp. H567	1697043	S	73	2	75	0.00017
Rhodoplanes sp. Z2-YC6860	674703	S	399	0	399	0.00091
Salinarchaeum sp. Harcht-Bsk1	1333523	S	13	0	13	0.00003
Azotobacter vinelandii	354	S	45	0	45	0.00010
Azotobacter chroococcum	353	S	66	12	78	0.00018
Magnetospirillum sp. XM-1	1663591	S	100	13	113	0.00026
Agrobacterium tumefaciens	358	S	268	86	354	0.00081
Acinetobacter equi	1324350	S	106	1	107	0.00024
Chryseobacterium gallinarum	1324352	S	243	30	273	0.00062
Sinorhizobium medicae	110321	S	78	5	83	0.00019
Marinovum algicola	42444	S	155	15	170	0.00039
Roseobacter litoralis	42443	S	18	1	19	0.00004
Chromohalobacter salexigens	158080	S	29	0	29	0.00007
Methyloceanibacter caenitepidi	1384459	S	73	0	73	0.00017
Cyanothece sp. PCC 7424	65393	S	10	1	11	0.00003
Ethanoligenens harbinense	253239	S	30	1	31	0.00007
Isoptericola dokdonensis	372663	S	326	29	355	0.00081
Pandoravirus salinus	1349410	S	31	1	32	0.00007
Xanthobacter autotrophicus	280	S	182	7	189	0.00043
Comamonas testosteroni	285	S	177	37	214	0.00049
Pseudomonas aeruginosa	287	S	314	25	339	0.00077
Fischerella sp. NIES-3754	1752063	S	55	8	63	0.00014
Streptomyces xiamenensis	408015	S	182	9	191	0.00044
Leptolyngbya sp. NIES-3755	1752064	S	12	0	12	0.00003
Phaeobacter inhibens	221822	S	45	4	49	0.00011
Roseburia hominis	301301	S	551	24	575	0.00131
Polaribacter vadi	1774273	S	15	0	15	0.00003
Paracoccus denitrificans	266	S	657	33	690	0.00157
Pseudarthrobacter chlorophenolicus	85085	S	175	10	185	0.00042
Gammaproteobacteria bacterium TR3.2	1810504	S	64	0	64	0.00015
Tsukamurella phage TPA2	981330	S	14	0	14	0.00003
Paenarthrobacter aurescens	43663	S	25	81	106	0.00024
Brachybacterium faecium	43669	S	910	33	943	0.00215
Rhizobium gallicum	56730	S	119	0	119	0.00027
Serratia liquefaciens	614	S	59	3	62	0.00014
Martelella sp. AD-3	686597	S	102	1	103	0.00024
Chloracidobacterium thermophilum	458033	S	16	0	16	0.00004
Flavobacterium johnsoniae	986	S	302	17	319	0.00073
Pedobacter heparinus	984	S	93	6	99	0.00023
Cytophaga hutchinsonii	985	S	33	0	33	0.00008
Staphylococcus phage 6ec	1500386	S	12	10	22	0.00005
Rubinisphaera brasiliensis	119	S	12	0	12	0.00003
Pseudomonas koreensis	198620	S	276	17	293	0.00067
Desulfurispirillum indicum	936456	S	12	0	12	0.00003
Bordetella flabilis	463014	S	59	1	60	0.00014
Bacillus endophyticus	135735	S	14	0	14	0.00003
Mannheimia varigena	85404	S	27	4	31	0.00007
Mycobacterium goodii	134601	S	250	15	265	0.00060
Staphylococcus condimenti	70255	S	106	2	108	0.00025
Beijerinckia indica	533	S	41	2	43	0.00010
Streptomyces sp. CNQ-509	444103	S	272	10	282	0.00064
Acidimicrobium ferrooxidans	53635	S	54	0	54	0.00012
Theileria orientalis	68886	S	437	42	479	0.00109
Psychrobacter sp. P2G3	1699622	S	13	9	22	0.00005
Cellulophaga algicola	59600	S	10	0	10	0.00002
Psychrobacter sp. P11G5	1699624	S	37	25	62	0.00014
Mycobacterium haemophilum	29311	S	65	0	65	0.00015
Corynebacterium sp. JZ16	1652495	S	33	4	37	0.00008
Pseudomonas sp. UW4	1207075	S	69	3	72	0.00017
Candidatus Koribacter versatilis	658062	S	39	0	39	0.00009
Collimonas fungivorans	158899	S	107	16	123	0.00028
Fictibacillus arsenicus	255247	S	10	1	11	0.00003
Thioalkalivibrio versutus	106634	S	25	1	26	0.00006
Listeria ivanovii	1638	S	16	0	16	0.00004
Pannonibacter phragmitetus	121719	S	106	2	108	0.00025
Rhodococcus jostii	132919	S	118	16	134	0.00031
Burkholderia sp. HB1	1678678	S	39	4	43	0.00010
Nocardia farcinica	37329	S	240	37	277	0.00063
Nocardia brasiliensis	37326	S	200	12	212	0.00048
Gordonia polyisoprenivorans	84595	S	169	6	175	0.00040
Acidovorax sp. JS42	232721	S	89	173	262	0.00060
Cyanobium gracile	59930	S	38	10	48	0.00011
Escherichia coli	562	S	646	330	976	0.00223
Shimwellia blattae	563	S	10	0	10	0.00002
Mycobacterium yongonense	1203599	S	11	59	70	0.00016
Laribacter hongkongensis	168471	S	31	0	31	0.00007
Dactylococcopsis salina	292566	S	14	5	19	0.00004
Thioalkalivibrio paradoxus	108010	S	42	11	53	0.00012
Haemophilus influenzae	727	S	1583	264	1847	0.00421
Niabella ginsenosidivorans	1176587	S	22	4	26	0.00006
Sinomonas atrocyanea	37927	S	375	12	387	0.00088
Acidipropionibacterium acidipropionici	1748	S	237	37	274	0.00062
Propionibacterium freudenreichii	1744	S	232	85	317	0.00072
Propionibacterium acnes	1747	S	11292	388	11680	0.02661
Clostridium saccharobutylicum	169679	S	15	0	15	0.00004
Haemophilus parainfluenzae	729	S	3907	77	3984	0.00908
Trichormus azollae	1164	S	85	8	93	0.00021
Anabaena cylindrica	1165	S	52	7	59	0.00014
Citrobacter rodentium	67825	S	11	0	11	0.00003
Filifactor alocis	143361	S	36	0	36	0.00008
Janthinobacterium sp. 1_2014MBL_MicDiv	1644131	S	350	38	388	0.00088
Corynebacterium aurimucosum	169292	S	1192	73	1265	0.00288
Clostridium acetobutylicum	1488	S	10	0	10	0.00002
Archangium gephyra	48	S	124	12	136	0.00031
Lactococcus piscium	1364	S	29	0	29	0.00007
Stigmatella aurantiaca	41	S	55	6	61	0.00014
Deinococcus radiodurans	1299	S	84	1	85	0.00020
Staphylococcus warneri	1292	S	1841	144	1985	0.00452
Pelagibacterium halotolerans	531813	S	71	1	72	0.00016
Pandoraea thiooxydans	445709	S	35	0	35	0.00008
Rhodococcus sp. p52	935199	S	69	73	142	0.00032
Sphingomonas panacis	1560345	S	1069	10	1079	0.00246
Bifidobacterium longum	216816	S	299	56	355	0.00081
Acinetobacter baumannii	470	S	478	251	729	0.00166
